Rasmus:
- lw : load word
- sw : store word
- li : load intermediate ***REMOVE***
- la : load address ***REMOVE***

Kasper:
- add : add
- sub : subtract

Attila:
- b : unconditional branch ***REMOVE***
- beq : branch on equal
- blt : branch less than ***REMOVE***
- ble : branch less and or equal ***REMOVE***
- bgt : branch greater than ***REMOVE***
- bge : branch greate than or equal ***REMOVE***
- bne : branch not equal

Kasper:
- j : unconditional jump
- jr : jump to addr in register
- jal : jump and link (store return addr)

Andreas:
Motivation etc.

New instructions to add:
- addi : add immediate
- subi : subtract immediate
- addu : add unsigned
- subu : subtract unsigned
- slt  : set less than
- and  : bitwise 'and'
- or   : bitwise 'or'

